#######################
#0....................#
#.....................#
#.....................#
#.....................#
#####################.#
#.....................#
#..................#
#                .....#
#.....................#           1
#.....................##          .
#.....................#           .
#..................................
#######################
          #